XXXXXXXXXXXXXXXXXXXXXXXXXXXXXXXXXXXXXXXXXXXXXXXXXXXXXXXXXXXXXXXXXXXXXXXXXXXXXXXXXXXXXXXXXXXXXXXXXXXXXXXXXXXXXXXXXXXXXXXX
X                                                                                                                      X
X                                                                                                                      X
X                                                                XXXXXXX                                               X
X                                                               XMMMMMMNX         XX                                   X
X                                                            XXXMMMMMMMMhXX      XmMX                                  X
X                                                          XXXMMMMMMMMMMMMNXX   XmMMMX                                 X
X                                                          XMMMMMMMMMMMMMMMMMX XmMMMMMX                    XXXXXX      X
X            XXXXXX                                        XMMMMMMMMMMMMMMMMMXXNMMMMMMMX                    X..X       X
X             X..X                                        XXMMMMMMMMMMMMMMMMy/NMMMMMMMMMX                XXXXXXXXXX    X
X          XXXXXXXXXX                                   XXXNMMMMMMMMMMMMMMMs-hMMMMMMMMMMMX                X      X     X
X           X      X                                   XNMMMMMMMMMMMMMMMMMm/.dMMMMMMMMMMMX                             X
X                                                      XMMMMMMMMMMMMMMMMMMd-yMMMMMMMMMMMMNX                            X
X                                                      XXMMMMMMMMNMMMMNMMN+`sMMMMMMMMMMMMNX                            X
X                                                       XXXMMMNXXXXMMXXXXXXXXXXXXXXXXXXXXXXX                           X
X                                                         XXXXXX  XMMX           XMX                                   X
X                                                                 XMMX           XMX                                   X
X                                                                 XMMX           XMX                                   X
X                                                                 XXXX           XXX              XXXXXX               X
X                             XXX                                                                  X..X                X
X                           XMMXXXX                                                             XXXXXXXXXX             X
X                          XXMMMMMMXX                                                            X      X              X
X                           XMMMMMmNMXX                                                                                X
X                        XXXmMMMMMdXXoXX                          XXXXXX                                               X
X                       XXXXMMMMMMMNsX                             X..X                                                X
X                         XhMNdMMMMmdXXXX                       XXXXXXXXXX                                             X
X                       XXXo:mMMMMMXXXXXXX                       X      X                                              X
X                     XXXXXdMMMMMMMMXX                                                           XXXXXXXX              X
X                         XNMMMMMmXXXXXXXX                                                        XXXXXX               X
X                     XXXXXXXXXXXXXXXX                                                             XXXX                X
X         XXXXXX               XXX                                                                X    X               X
X          X..X                XXX                                                               X      X              X
X       XXXXXXXXXX             XXX                                                                                     X
X         X    X                                                                                                       X
X                                                              XXXXXX                                                  X
X                                                               X..X                                                   X
X                                                            XXXXXXXXXX                                                X
X                                                             X      X                                                 X
X                                                                                                                      X
XXXXXXXXXXXXXXXXXXXXXXXXXXXXXXXXXXXXXXXXXXXXXXXXXXXXXXXXXXXXXXXXXXXXXXXXXXXXXXXXXXXXXXXXXXXXXXXXXXXXXXXXXXXXXXXXXXXXXXXX
