XXXXXXXXXXXXXXXXXXXXXXXXXXXXXXXXXXXXXXXXXXXXXXXXXXXXXXXXXXXXXXXXXXXXXXXXXXXXXXXXXXXXXXXXXXXXXXXXXXXXXXXXXXXXXXXXXXXXXXXX
X     X.’.’.’.’.’.’.’.’.’.’.’.’.’.’.’.’.’.’.’.’.*.’.’.’.’.’.’*’.’.’.’.’.’.’.’.’.’.’.’.’.’.’.’.’.’.’.’*’.’.’.’.’.’.’.’.’X
X     X.’.’.’.’.’.’.’.’.’.’.’.’.’.’.’.’.’.’.’.’***’.’.’.’.’.***.’.’.’.’.’.’.’.’.’.’.’.’.’.’.’.’.’.’.***.’.’.’.’.’.’.’.’X
X     X.’.’.’.’.’.’.’.’.’.’.’.’.’.’.’.’.’.’.’.*****.’.’.’.’*****’.’.’.’.’.’.’.’.’.’.’.’.’.’.’.’.’.’*****’.’.’.’.’.’.’.’X
X     X.’.’.’.’.’.’.’.’.’.’.’.’.’.’.’.’.’.’.’*******’.’.’.*******.’.’.’.’.’.’.’.’.’.’.’.’.’.’.’.’.*******.’.’.’.’.’.’.’X
X     X.’.’.’.’.’.’.’.’.’.’.’.’.’.’.’.’.’.’.’.’.|.’.’.’.’.’.’|’.’.’.’.’.’.’.’.’.’.’.’.’.’.’.’.’.’.’.’|’.’.’.’.’.’.’.’.’X
X     XXXXXXXXXXXXXXXXXXXXXXXXXXXXXXXXXXXXXXXXXXXXXXXXXXXXXXXXXXXXXXXXXXXXXXXXXXXXXXXXXXXXXXXXXXXXXXXXXXXXXXXXXXXXXXXXXX
X      XXXXXXXXXXXXXXXXXXXXXXXXXXXXXXXXXXXXXXXXXXXXXXXXXXXXXXXXXXXXXXXXXXXXXXXXXXXXXXXXXXXXXXXXXXXXXXXXXXXXXXXXXXXXXXXXX
X       XXXXXXXXXXXXXXXXXXXXXXXXXXXXXXXXXXXXXXXXXXXXXXXXXXXXXXXXXXXXXXXXXXXXXXXXXXXXXXXXXXXXXXXXXXXXXXXXXXXXXXXXXXXXXXXX
XX       XXXXXXXXXXXXXXXXXXXXXXXXXXXXXXXXXXXXXXXXXXXXXXXXXXXXXXXXXXXXXXXXXXXXXXXXXXXXXXXXXXXXXXXXXXXXXXXXXXXXXXXXXXXXXXX                                                                                                                                                                                                     XXX       XXXXXXXXXXXXXXXXXXXXXXXXXXXXXXXXXXXXXXXXXXXXXXXXXXXXXXXXXXXXXXXXXXXXXXXXXXXXXXXXXXXXXXXXXXXXXXXXXXXXXXXXXXXXXX                                                                                                                 
XXXX      XXXXXXXXXXXXXXXXXXXXXXXXXXXXXXXXXXXXXXXXXXXXXXXXXXXXXXXXXXXXXXXXXXXXXXXXXXXXXXXXXXXXXXXXXXXXXXXXXXXXXXXXXXXXXX
XXXX      XXXXXXXXXXXXXXXXXXXXXXXXXXXXXXXXXXXXXXXXXXXXXXXXXXXXXXXXXXXXXXXXXXXXXXXXXXXXXXXXXXXXXXXXXXXXXXXXXXXXXXXXXXXXXX
XXXX      XXXXXXXXXXXXXXXXXXXXXXXXXXXXXXXXXXXXXXXXXXXXXXXXXXXXXXXXXXXXXXXXXXXXXXXXXXXXXXXXXXXXXXXXXXXXXXXXXXXXXXXXXXXXXX
XXXX      XXXXXXXXXXXXXXXXXXXXXXXXXXXXXXXXXXXXXXXXXXXXXXXXXXXXXXXXXXXXXXXXXXXXXXXXXXXXXXXXXXXXXXXXXXXXXXXXXXXXXXXXXXXXXX                                                                                                                      XXXX                  XXXXXXXXXXXXXXXXXXXXXXXXXXXXXXXXXXXXXXXXXXXXXXXXXXXXXXXXXXXXXXXXXXXXXXXXXXXXXXXXXXXXXXXXXXXXXXXXXX
XXXX                   XXXXXXXXXXXXXXXXXXXXXXXXXXXXXXXXXXXXXXXXXXXXXXXXXXXXXXXXXXXXXXXXXXXXXXXXXXXXXXXXXXXXXXXXXXXXXXXXX
XXXX                    XXXXXXXXXXXXXXXXXXXXXXXXXXXXXXXXXXXXXXXXXXXXXXXXXXXXXXXXXXXXXXXXXXXXXXXXXXXXXXXXXXXXXXXXXXXXXXXX
XXXXXXXXXXXXXXXX         XXXXXXXXXXXXXXXXXXXXXXXXXXXXXXXXXXXXXXXXXXXXXXXXXXXXXXXXXXXXXXXXXXXXXXXXXXXXXXXXXXXXXXXXXXXXXXX
XXXXXXXXXXXXXXXXX                                                                                                      X
XXXXXXXXXXXXXXXXXX                                                                                                     X
XXXXXXXXXXXXXXXXXXX                                                                                                    X
XXXXXXXXXXXXXXXXXXXX                                                                                                   X
XXXXXXXXXXXXXXXXXXXXX                                                                                                  X
XXXXXXXXXXXXXXXXXXXXXX                                                                                                 X
XXXXXXXXXXXXXXXXXXXXXXX                                                                                                X
XXXXXXXXXXXXXXXXXXXXXXXX                                                                                               X
XXXXXXXXXXXXXXXXXXXXXXXXX                                                                                              X
XXXXXXXXXXXXXXXXXXXXXXXXX                                                                                              X
XXXXXXXXXXXXXXXXXXXXXXXXX                                                                                              X
XXXXXXXXXXXXXXXXXXXXXXXXX                                                                                              X
XXXXXXXXXXXXXXXXXXXXXXXXX                                                                                              X
XXXXXXXXXXXXXXXXXXXXXXXXX                                                                                              X
XXXXXXXXXXXXXXXXXXXXXXXXX                                                                                              X
XXXXXXXXXXXXXXXXXXXXXXXXX                                                                                              X
XXXXXXXXXXXXXXXXXXXXXXXXX                                                                                              X
XXXXXXXXXXXXXXXXXXXXXXXXX                                                                                              X
XXXXXXXXXXXXXXXXXXXXXXXXX                                                                                              X
XXXXXXXXXXXXXXXXXXXXXXXXX                                                                                              X
XXXXXXXXXXXXXXXXXXXXXXXXX                                                                                              X
XXXXXXXXXXXXXXXXXXXXXXXXX                                                                                              X
XXXXXXXXXXXXXXXXXXXXXXXXXXXXXXXXXXXXXXXXXXXXXXXXXXXXXXXXXXXXXXXXXXXXXXXXXXXXXXXXXXXXXXXXXXXXXXXXXXXXXXXXXXXXXXXXXXXXXXXX