#######################################################################################################################
#           #           #               #                   #   #       #           #           #           #       # #
#           #           #               #                   #   #       #           #           #           #       # #
#   #####   #   #####   #   #########   #################   #   #   #   #   #####   #   #####   #   #####   #   #   # #
#       #       #       #       #   #           #       #       #   #   #   #   #   #   #       #       #   #   #   # #
#       #       #       #       #   #           #       #       #   #   #   #   #   #   #       #       #   #   #   # #
#################   #########   #   #########   #   #   #####   #   #   #   #   #   #####   #########   #   #   #   # #
#   #       #       #           #               #   #       #       #   #   #   #   #               #   #   #   #   # #
#   #       #       #           #               #   #       #       #   #   #   #   #               #   #   #   #   # #
#   #   #   #   #####   #####   #   #####################   #####   #####   #   #   #   #   #####   #   #   #####   # #
#   #   #   #   #           #   #   #       #       #   #       #       #       #   #   #   #       #   #       #   # #
#   #   #   #   #           #   #   #       #       #   #       #       #       #   #   #   #       #   #       #   # #
#   #   #   #   #########   #   #   #   #   #####   #   #####   #####   #   #####   #####   #   #   #########   #   # #
#       #   #           #   #   #       #           #   #   #       #   #       #       #   #   #       #           # #
#       #   #           #   #   #       #           #   #   #       #   #       #       #   #   #       #           # #
#   #   #####   #####   #   #################   #####   #   #####   #   #   #   #####   #   #   #####   #   #   ##### #
#   #           #       #       #               #           #       #   #   #       #       #       #   #   #   #   # #
#   #           #       #       #               #           #       #   #   #       #       #       #   #   #   #   # #
#   #############   #########   #   #############   #####   #   #####   #   #####################   #   #####   #   # #
#   #       #   #               #       #       #       #               #           #   #           #           #   # #
#   #       #   #               #       #       #       #               #           #   #           #           #   # #
#   #   #   #   #####   #############   #   #   #####   #####   #################   #   #   #####################   # #
#   #   #       #       #           #   #   #       #   #   #   #               #   #       #           #           # #
#   #   #       #       #           #   #   #       #   #   #   #               #   #       #           #           # #
#   #   #####   #   #############   #   #   #####   #   #   #   #   #   #   #####   #########   #####   #   ######### #
#   #   #       #       #       #       #   #       #   #       #   #   #       #   #       #   #   #   #           # #
#   #   #       #       #       #       #   #       #   #       #   #   #       #   #       #   #   #   #           # #
#   #####   #########   #   #   #########   #   #####   #   #####   #   #####   #   #####   #   #   #   #   #####   # #
#           #       #   #   #   #           #   #       #           #   #   #   #       #   #   #       #   #       # #
#           #       #   #   #   #           #   #       #           #   #   #   #       #   #   #       #   #       # #
#########   #   #   #   #####   #   #########   #   #################   #   #   #   #   #   #   #########   #   ##### #
#       #   #   #   #   #       #   #               #   #           #   #       #   #   #                   #       # #
#       #   #   #   #   #       #   #               #   #           #   #       #   #   #                   #       # #
#   #   #   #   #   #   #   #####   #   #####   #####   #   #########   #####   #   #   #########   #############   # #
#   #       #   #   #       #       #   #   #           #               #       #   #   #       #           #       # #
#   #       #   #   #       #       #   #   #           #               #       #   #   #       #           #       # #
#   #############   #   #####   #####   #   #####   #   #########   #####   #####   #   #   #   #   #####   #   ##### #
#                   #           #       #           #           #       #           #       #       #       #         #
#                   #           #       #           #           #       #           #       #       #       #        ♜#
#######################################################################################################################
