XXXXXXXXXXXXXXXXXXXXXXXXXXXXXXXXXXXXXXXXXXXXXXXXXXXXXXXXXXXXXXXXXXXXXXXXXXXXXXXXXXXXXXXXXXXXXXXXXXXXXXXXXXXXXXXXXXXXXXX
X           X           X               X                   X   X       X           X           X           X       X X
X           X           X               X                   X   X       X           X           X           X       X X
X   XXXXX   X   XXXXX   X   XXXXXXXXX   XXXXXXXXXXXXXXXXX   X   X   X   X   XXXXX   X   XXXXX   X   XXXXX   X   X   X X
X       X       X       X       X   X           X       X       X   X   X   X   X   X   X       X       X   X   X   X X
X       X       X       X       X   X           X       X       X   X   X   X   X   X   X       X       X   X   X   X X
XXXXXXXXXXXXXXXXX   XXXXXXXXX   X   XXXXXXXXX   X   X   XXXXX   X   X   X   X   X   XXXXX   XXXXXXXXX   X   X   X   X X
X   X       X       X           X               X   X       X       X   X   X   X   X               X   X   X   X   X X
X   X       X       X           X               X   X       X       X   X   X   X   X               X   X   X   X   X X
X   X   X   X   XXXXX   XXXXX   X   XXXXXXXXXXXXXXXXXXXXX   XXXXX   XXXXX   X   X   X   X   XXXXX   X   X   XXXXX   X X
X   X   X   X   X           X   X   X       X       X   X       X       X       X   X   X   X       X   X       X   X X
X   X   X   X   X           X   X   X       X       X   X       X       X       X   X   X   X       X   X       X   X X
X   X   X   X   XXXXXXXXX   X   X   X   X   XXXXX   X   XXXXX   XXXXX   X   XXXXX   XXXXX   X   X   XXXXXXXXX   X   X X
X       X   X           X   X   X       X           X   X   X       X   X       X       X   X   X       X           X X
X       X   X           X   X   X       X           X   X   X       X   X       X       X   X   X       X           X X
X   X   XXXXX   XXXXX   X   XXXXXXXXXXXXXXXXX   XXXXX   X   XXXXX   X   X   X   XXXXX   X   X   XXXXX   X   X   XXXXX X
X   X           X       X       X               X           X       X   X   X       X       X       X   X   X   X   X X
X   X           X       X       X               X           X       X   X   X       X       X       X   X   X   X   X X
X   XXXXXXXXXXXXX   XXXXXXXXX   X   XXXXXXXXXXXXX   XXXXX   X   XXXXX   X   XXXXXXXXXXXXXXXXXXXXX   X   XXXXX   X   X X
X   X       X   X               X       X       X       X               X           X   X           X           X   X X
X   X       X   X               X       X       X       X               X           X   X           X           X   X X
X   X   X   X   XXXXX   XXXXXXXXXXXXX   X   X   XXXXX   XXXXX   XXXXXXXXXXXXXXXXX   X   X   XXXXXXXXXXXXXXXXXXXXX   X X
X   X   X       X       X           X   X   X       X   X   X   X               X   X       X           X           X X
X   X   X       X       X           X   X   X       X   X   X   X               X   X       X           X           X X
X   X   XXXXX   X   XXXXXXXXXXXXX   X   X   XXXXX   X   X   X   X   X   X   XXXXX   XXXXXXXXX   XXXXX   X   XXXXXXXXX X
X   X   X       X       X       X       X   X       X   X       X   X   X       X   X       X   X   X   X           X X
X   X   X       X       X       X       X   X       X   X       X   X   X       X   X       X   X   X   X           X X
X   XXXXX   XXXXXXXXX   X   X   XXXXXXXXX   X   XXXXX   X   XXXXX   X   XXXXX   X   XXXXX   X   X   X   X   XXXXX   X X
X           X       X   X   X   X           X   X       X           X   X   X   X       X   X   X       X   X       X X
X           X       X   X   X   X           X   X       X           X   X   X   X       X   X   X       X   X       X X
XXXXXXXXX   X   X   X   XXXXX   X   XXXXXXXXX   X   XXXXXXXXXXXXXXXXX   X   X   X   X   X   X   XXXXXXXXX   X   XXXXX X
X       X   X   X   X   X       X   X               X   X           X   X       X   X   X                   X       X X
X       X   X   X   X   X       X   X               X   X           X   X       X   X   X                   X       X X
X   X   X   X   X   X   X   XXXXX   X   XXXXX   XXXXX   X   XXXXXXXXX   XXXXX   X   X   XXXXXXXXX   XXXXXXXXXXXXX   X X
X   X       X   X   X       X       X   X   X           X               X       X   X   X       X           X       X X
X   X       X   X   X       X       X   X   X           X               X       X   X   X       X           X       X X
X   XXXXXXXXXXXXX   X   XXXXX   XXXXX   X   XXXXX   X   XXXXXXXXX   XXXXX   XXXXX   X   X   X   X   XXXXX   X   XXXXX X
X                   X           X       X           X           X       X           X       X       X       X         X
X                   X           X       X           X           X       X           X       X       X       X        ♜X
XXXXXXXXXXXXXXXXXXXXXXXXXXXXXXXXXXXXXXXXXXXXXXXXXXXXXXXXXXXXXXXXXXXXXXXXXXXXXXXXXXXXXXXXXXXXXXXXXXXXXXXXXXXXXXXXXXXXXXX
