XXXXXXXXXXXXXXXXXXXXXXXXXXXXXXXXXXXXXXXXXXXXXXXXXXXXXXXXXXXXXXXXXXXXXXXXXXXXXXXXXXXXXXXXXXXXXXXXXXXXXXXXXXXXXXXXXXXXXXXX
X                                                                                                                      X
X                                                                                                                      X
X                                                                                                                      X
X                                                                                                                      X
X                                                                                                                      X
X                                                                                                                      X
X                                                                                                                      X
X                                                                                                                      X
X      XXX                                                                                                             X
X     Xo##X                                                                                                            X
X   X####o##X                                                                                                          X
X  Xo#\#|#/##X                                                                                                         X
X   X##\|/#oX                                                                                                          X
X    XX}|{XX                                                                                                           X
X      X|X                                                                                                             X
X      XXX                                                                                  X                          X
X                                                                                                                     XX
X                                                                                                                      X
X                                                                                                                      X
X                                                                                                                      X
X                                 X                                                                                    X
X                                                                                                                      X
X                                                                                                                      X
X                                                                                                                      X
X                                                                                                                      X
X                                                                                                                      X
X                                                                                                                      X
X                                                                                                                      X
X                                                                                                                      X
X                                                                                                                      X
X                                                                                                                      X
X                                                                                            X                         X
X                                                                                                                      X
X                                                                                                                      X
X                                                                                                                      X
X                                                                                                                      X
X                                                                                                                      X
X                                                                                                                      X
XXXXXXXXXXXXXXXXXXXXXXXXXXXXXXXXXXXXXXXXXXXXXXXXXXXXXXXXXXXXXXXXXXXXXXXXXXXXXXXXXXXXXXXXXXXXXXXXXXXXXXXXXXXXXXXXXXXXXXXX
