########################################################################################################################
#           #           #               #                   #   #       #           #           #           #       #  #
#           #           #               #                   #   #       #           #           #           #       #  #
#   #####   #   #####   #   #########   #################   #   #   #   #   #####   #   #####   #   #####   #   #   #  #
#       #       #       #       #   #           #       #       #   #   #   #   #   #   #       #       #   #   #   #  #
#       #       #       #       #   #           #       #       #   #   #   #   #   #   #       #       #   #   #   #  #
#################   #########   #   #########   #   #   #####   #   #   #   #   #   #####   #########   #   #   #   #  #
#   #       #       #           #               #   #       #       #   #   #   #   #               #   #   #   #   #  #
#   #       #       #           #               #   #       #       #   #   #   #   #               #   #   #   #   #  #
#   #   #   #   #####   #####   #   #####################   #####   #####   #   #   #   #   #####   #   #   #####   #  #
#   #   #   #   #           #   #   #       #       #   #       #       #       #   #   #   #       #   #       #   #  #
#   #   #   #   #           #   #   #       #       #   #       #       #       #   #   #   #       #   #       #   #  #
#   #   #   #   #########   #   #   #   #   #####   #   #####   #####   #   #####   #####   #   #   #########   #   #  #
#       #   #           #   #   #       #           #   #   #       #   #       #       #   #   #       #           #  #
#       #   #           #   #   #       #           #   #   #       #   #       #       #   #   #       #           #  #
#   #   #####   #####   #   #################   #####   #   #####   #   #   #   #####   #   #   #####   #   #   #####  #
#   #           #       #       #               #           #       #   #   #       #       #       #   #   #   #   #  #
#   #           #       #       #               #           #       #   #   #       #       #       #   #   #   #   #  #
#   #############   #########   #   #############   #####   #   #####   #   #####################   #   #####   #   #  #
#   #       #   #               #       #       #       #               #           #   #           #           #   #  #
#   #       #   #               #       #       #       #               #           #   #           #           #   #  #
#   #   #   #   #####   #############   #   #   #####   #####   #################   #   #   #####################   #  #
#   #   #       #       #           #   #   #       #   #   #   #               #   #       #           #           #  #
#   #   #       #       #           #   #   #       #   #   #   #               #   #       #           #           #  #
#   #   #####   #   #############   #   #   #####   #   #   #   #   #   #   #####   #########   #####   #   #########  #
#   #   #       #       #       #       #   #       #   #       #   #   #       #   #       #   #   #   #           #  #
#   #   #       #       #       #       #   #       #   #       #   #   #       #   #       #   #   #   #           #  #
#   #####   #########   #   #   #########   #   #####   #   #####   #   #####   #   #####   #   #   #   #   #####   #  #
#           #       #   #   #   #           #   #       #           #   #   #   #       #   #   #       #   #       #  #
#           #       #   #   #   #           #   #       #           #   #   #   #       #   #   #       #   #       #  #
#########   #   #   #   #####   #   #########   #   #################   #   #   #   #   #   #   #########   #   #####  #
#       #   #   #   #   #       #   #               #   #           #   #       #   #   #                   #       #  #
#       #   #   #   #   #       #   #               #   #           #   #       #   #   #                   #       #  #
#   #   #   #   #   #   #   #####   #   #####   #####   #   #########   #####   #   #   #########   #############   #  #
#   #       #   #   #       #       #   #   #           #               #       #   #   #       #           #       #  #
#   #       #   #   #       #       #   #   #           #               #       #   #   #       #           #       #  #
#   #############   #   #####   #####   #   #####   #   #########   #####   #####   #   #   #   #   #####   #   #####  #
#                   #           #       #           #           #       #           #       #       #       #          #
#                   #           #       #           #           #       #           #       #       #       #        ♜ #
########################################################################################################################
